AM	AE M
AM(2)	EY EH M
ARE	AA R
ARE(2)	ER
BACKWARD	B AE K W ER D
BROWSER	B R AW Z ER
BYE	B AY
CURIE	K Y UH R IY
FORWARD	F AO R W ER D
HOW	HH AW
I	AY
LEFT	L EH F T
LOVE	L AH V
ME	M IY
MOVE	M UW V
OFF	AO F
OPEN	OW P AH N
RIGHT	R AY T
TO	T UW
TO(2)	T IH
TO(3)	T AH
TURN	T ER N
WHO	HH UW
YOU	Y UW
